11111111111111111111111111
1P000010C00000000001000001
10101011111101111101011101
11101010000001000100000101
10001011111101010001110001
10001011110101110000110001
10101011100100011110111101
1010000C001111011C10111101
10111110111111011010100001
10000010000000011010111011
111111101111111110101C1011
11100000011111000000101011
11100E11011111100000001C11
11111111111111111111111111
