1111111111111111111111
1P00101000000100000001
1110101111010111010101
10001000010101010111C1
1010101100010001000101
1010001000111000010101
10110110100C1011011101
1001000010100010010101
1011111011101110110101
1000101000001000010001
1111100010111111111101
1010111010101000100101
1010000010001010101101
1011111010111000100101
1010101110000011101111
1000100000101010000001
1110111011101000100101
1010001000101010110111
1000101010101010010001
1C11111010100011110101
10000000001010100001E1
1111111111111111111111
